1111111111111111111111111111111111
1E000000C00001111111100000C0000001
1010010100100C00101001000C00010101
101001001010101000110100000C010101
1P00000CC00111000C0C00C00C01000001
1111111111111111111111111111111111