1111111111111111
1E000000C00C0001
1C10010100100C01
101001C010101011
100C0010010C0001
1P0000C00C000011
1111111111111111