11111111111111111111
1P000001E10000000001
11110000000000100001
10000010100111100001
10111010100100000001
101C1010110100000001
1C1000101C0100000001
11101010111100000001
10001010000100000001
11111011111101011111
1C0000000000C10000C1
11111111111111111111