1111111111111
10010000C0001
1000010000101
1P0000E0C0001
1111111111111