111111111111111111111111111111
100PE1C0C00101C0000110000100C1
1100C10C0000001010010C000111C1
111C0CC01000110C0000C01000C001
100010C100C1C00C100010C00C1001
1000CC01110C1010CCCC0C10001001
1C0C01C100C1C00C0010C0C0CCC111
1CCCC0C1CC000001000100111000C1
1C00110C1100000000CC0100001011
100C01011C1000000100C0C11001C1
11000000C000100C10000111011CC1
111C01010C00000000C0101CC11C01
11C0001CC00CC00001C00010001C11
1C1001C0C0C1C000C01CC00000C001
10000000010C0CC110001C010110C1
101CC101C0C00C00C10C00CC0C0111
11C1011C0010001CC001001101C101
100CCC0001C0100C1000C0001C00C1
100100C0000C111C1111010C001001
111111111111111111111111111111