111111111111111111111111111111111111111111111111111111111111
100PE1C0C0010MC0000110000100C000110000M00CM00C000110000100C1
1100CM0C0000001010010C000111CM0010C000111C111C10010C00011MC1
111C0CC01000110C0000C010M0C000000C01000C000C000000C01000C001
100000C100C1C00C1000M0C00C100100010C00C100C1001000M0C00CM001
1000CC01110C1010CCCC0C1000100CCCC0C10001000100CCCC0C10001001
1C0C01C100C1C00C0010C0C0CCC110010C0C0CCC11CC110010C0C0CCC111
1CCCC0C1CC000001000100111000C00010011M000C000C000M00MM1000C1
1C00110C1M00000000CC010M0010100CC010000101010100CC0100M01011
100C01011CM000000100C0C11001C0M00C0C11001C001C0100C0C1100MC1
11000000C000100C10000111011CCM0000MMM011CC1MCC1000011M011CC1
111C010M0C00000000C0101CCM1C000C0101CC11C011C000C0101CCM1C01
11C000MCC00CC00001C00010001C101C00M10001C101C101C0001000MC11
1C100MC0C0CMC000C0MCC00000C00C0MCC00000C000C00C0MCC00000C001
100000000M0C0CC110001C010110CM0001C010110C110C1000MC010110C1
101CC10MC0C00C00CM0C00CC0C0MMCM0C00CC0C0MMC011C10C00CC0C0111
11C1011C00M0001CC001001101C10C001001M01C101C10C001001101C101
100CCC0001C0100C1000C0001C00C1000C000MC00CC00C1000C0001C00C1
100100C00M0C111C1111010C001001M11010C001000100111M010C0010M1
111111111111111111111111111111111111111111111111111111111111