11111111111111111111111111111111111
111100000000000001M10C0000000000001
10000111100CCC00011MC01100000C00001
1P0010C000C0M0C000000000MMMM0000001
11110CC000000C00C11111C000000000001
1000C0C00000C0010001111111100000001
100C00C0000C0001CC0011C00C111110001
10CCCCCC00C0000111C0000111111000011
100000C00CCCCCC00001MC0000011000111
10E0111110011111101000110C000000001
11111111111111111111111111111111111