11111111111111111111
1P000000E10000000001
11110C00101000100001
11111111111111111111